0000000000000000000000
0                    0
0   1111  1          0
0         1          0
0         1  1111    0
0                    0
0                    0
0   1111  1          0
0         1          0
0         1  1111    0
0                    0
0   1111  1   A      0
0         1          0
0     A   1  1111    0
0                    0
0000000000000000000000