0000000000000000000000
0         2          0
0         2     A    0
0         2          0
0         2          0
0    111111111111    0
0    1    2          0
0         3   A      0
0         3          0
0    1    2          0
0    111111111111    0
0         2          0
0         2          0
0    A    2     A    0
0         2          0
0000000000000000000000