0000000000000000000000
0                    0
0         2     A    0
0        222111      0
0                    0
0   111   1111111    0
0         1     1    0
0                    0
0    1111     A      0
0    1    1          0
0   1112221122211    0
0                    0
0     111222111      0
0  A      2      A   0
0                    0
0000000000000000000000