0000000000000000000000
0       1 1 1        0
0       1 1 1   A    0
0    1111 1 1        0
0            2   A   0
0            2       0
0   333      23      0
0               A    0
0    A   2           0
0      321   23333   0
0       2    2       0
0       2    2       0
0                    0
0   A   1   A   A    0
0       1            0
0000000000000000000000