0000000000000000000000
0       1    1       0
0       1    1       0
0  111111            0
0       2    2       0
0       2    2       0
0   333321  123333   0
0        2  2        0
0        2  2        0
0   333321  123333   0
0       2    2       0
0       2    2       0
0            111111  0
0       1    1       0
0       1    1       0
0000000000000000000000